****************
*    *    *   E*
*    *    *  ***
*    *    *    *
*    *    *    *
*    *    *    *
*S             *
****************