****************
*S   *    *    *
*    *    *    *
*    *    *   E*
*    *    *    *
*    *         *
*    *         *
*    *    *    *
*         *    *
****************